#####
#@$.#
#####
;
 ##########
#         #
#   @$.   #
#   $     #
#   .     #
###########
